11111
1P0E1
1CCC1
1D001
11111
