111111111111111
1P001000C100001
1000101111010C1
111010D1E101011
1C0000000001001
101111111101101
1000C1C00000001
111111111111111
